{
  "A1": 10,
  "A2": 9,
  "A3": 9,
  "A4": 8,
  "A5": 8,
  "A6": 7,
  "A7": 7,
  "A8": 7,
  "B1": 9,
  "B2": 9,
  "B3": 8,
  "B4": 8,
  "B5": 7,
  "B6": 7,
  "B7": 7,
  "B8": 7,
  "C1": 9,
  "C2": 8,
  "C3": 8,
  "C4": 7,
  "C5": 7,
  "C6": 7,
  "C7": 6,
  "C8": 7,
  "D1": 8,
  "D2": 8,
  "D3": 7,
  "D4": 7,
  "D5": 7,
  "D6": 6,
  "D7": 6,
  "D8": 6,
  "E1": 8,
  "E2": 7,
  "E3": 7,
  "E4": 7,
  "E5": 6,
  "E6": 6,
  "E7": 5,
  "E8": 6,
  "F1": 7,
  "F2": 7,
  "F3": 7,
  "F4": 6,
  "F5": 6,
  "F6": 5,
  "F7": 5,
  "F8": 5,
  "G1": 7,
  "G2": 7,
  "G3": 6,
  "G4": 6,
  "G5": 5,
  "G6": 5,
  "G7": 4,
  "G8": 5,
  "H1": 7,
  "H2": 6,
  "H3": 6,
  "H4": 5,
  "H5": 5,
  "H6": 4,
  "H7": 4,
  "H8": 4,
  "I1": 6,
  "I2": 6,
  "I3": 5,
  "I4": 5,
  "I5": 4,
  "I6": 4,
  "I7": 4,
  "I8": 4,
  "J1": 6,
  "J2": 5,
  "J3": 5,
  "J4": 4,
  "J5": 4,
  "J6": 4,
  "J7": 3,
  "J8": 4,
  "K1": 5,
  "K2": 5,
  "K3": 4,
  "K4": 4,
  "K5": 4,
  "K6": 3,
  "K7": 3,
  "K8": 3,
  "L1": 5,
  "L2": 4,
  "L3": 4,
  "L4": 4,
  "L5": 3,
  "L6": 3,
  "L7": 2,
  "L8": 3,
  "M1": 4,
  "M2": 4,
  "M3": 4,
  "M4": 3,
  "M5": 3,
  "M6": 2,
  "M7": 2,
  "M8": 2,
  "N1": 4,
  "N2": 4,
  "N3": 3,
  "N4": 3,
  "N5": 2,
  "N6": 2,
  "N7": 1,
  "N8": 2,
  "O1": 4,
  "O2": 3,
  "O3": 3,
  "O4": 2,
  "O5": 2,
  "O6": 1,
  "O7": 1,
  "O8": 1,
  "P1": 3,
  "P2": 3,
  "P3": 2,
  "P4": 2,
  "P5": 1,
  "P6": 1,
  "P7": 1,
  "P8": 1
}